"a" = (/turf/open/outside,/area/space)
"b" = (/turf/open/floor/plasteel,/area/space)
"c" = (/obj/structure/ladder,/turf/open/outside,/area/space)

(1,1,1) = {"
aaaaaaaaaaaaaaaaaaaaaaaaaa
aaaaaaaaaaaaaaaaaaaaaaaaaa
aaaaaaaaaaaaaaaaaaaaaaaaaa
aaaaaaaaaaaaaaaaaaaaaaaaaa
aaaaaaaaaaaaaaaaaaaaaaaaaa
aaaaaaaaaaaaaaaaaaaaaaaaaa
aaaaaaaaaaaaaaaaaaaaaaaaaa
aaaaaaaaaaaaaaaaaaaaaaaaaa
aaaaaaaaabaaaaaaaaaaaaaaaa
aaaaaaaabbaaaaaaaaaaaaaaaa
aaaaaaabbbaaaaaaaaaaaaaaaa
aaaaabbaabaaaaaaaaaaaaaaaa
aaaaabaaabaaaaaaaaaaaaaaaa
aaaaaaaaabaaaaaaaaaaaaaaaa
aaaaaaaabaaaaaaaaaaaaaaaaa
aaaaaaaabaaaaaaaaaaaaaaaaa
aaaaaaaabaaaaaaaaaaaaaaaaa
aaaaaaaabaaaaaaaaaaaaaaaaa
aaaaaaaaaaaaaaaaaaaaaaaaaa
aaaaaaaaaaaaaaaaaaaaaaaaaa
aaaaaaaaaaaaaaaaaaaaaaaaaa
aaaaaaaaaaaaaaaaaaaaaaaaaa
aaaaaaaaaaaaaaaaaaaaaaaaaa
aaaaaaaaaaaaaaaaaaaaaaaaaa
aaaaaaaaaaaaaaaaaaaaaaaaaa
caaaaaaaaaaaaaaaaaaaaaaaaa
"}

(1,1,2) = {"
aaaaaaaaaaaaaaaaaaaaaaaaaa
aaaaaaaaaaaaaaaaaaaaaaaaaa
aaaaaaaaaaaaaaaaaaaaaaaaaa
aaaaaaaaaaaaaaaaaaaaaaaaaa
aaaaaaaaaaaaaaaaaaaaaaaaaa
aaaaaaaaaaaaaaaaaaaaaaaaaa
aaaaaaaaaaaaaaaaaaaaaaaaaa
aaaaaaaaaaaaaaaaaaaaaaaaaa
aaabbbbaaaaaaaaaaaaaaaaaaa
aaaaaabaaaaaaaaaaaaaaaaaaa
aaaaaabaaaaaaaaaaaaaaaaaaa
aaaaaabaaaaaaaaaaaaaaaaaaa
aaaabbbaaaaaaaaaaaaaaaaaaa
aabbbaaaaaaaaaaaaaaaaaaaaa
aabbbbbbbbaaaaaaaaaaaaaaaa
aaaaaaaaaaaaaaaaaaaaaaaaaa
aaaaaaaaaaaaaaaaaaaaaaaaaa
aaaaaaaaaaaaaaaaaaaaaaaaaa
aaaaaaaaaaaaaaaaaaaaaaaaaa
aaaaaaaaaaaaaaaaaaaaaaaaaa
aaaaaaaaaaaaaaaaaaaaaaaaaa
aaaaaaaaaaaaaaaaaaaaaaaaaa
aaaaaaaaaaaaaaaaaaaaaaaaaa
caaaaaaaaaaaaaaaaaaaaaaaaa
aaaaaaaaaaaaaaaaaaaaaaaaaa
caaaaaaaaaaaaaaaaaaaaaaaaa
"}

(1,1,3) = {"
aaaaaaaaaaaaaaaaaaaaaaaaaa
aaaaaaaaaaaaaaaaaaaaaaaaaa
aaaaaaaaaaaaaaaaaaaaaaaaaa
aaaaaaaaaaaaaaaaaaaaaaaaaa
aaaaaaaaaaaaaaaaaaaaaaaaaa
aaaaaaaaaaaaaaaaaaaaaaaaaa
aaaaaaaaaaaaaaaaaaaaaaaaaa
aaaaaaaaaaaaaaaaaaaaaaaaaa
aaaaaaaabbbbbaaaaaaaaaaaaa
aaaaaaaaaaaabbbaaaaaaaaaaa
aaaaaaaaaaaaaabaaaaaaaaaaa
aaaaaaaaaabbbbbaaaaaaaaaaa
aaaaaaaaaabbbaaaaaaaaaaaaa
aaaaaaaaaaaabbaaaaaaaaaaaa
aaaaaaaaaaaaabaaaaaaaaaaaa
aaaaaaaaaaaaabaaaaaaaaaaaa
aaaaaaaaaaaabaaaaaaaaaaaaa
aaaaaaaaabbbaaaaaaaaaaaaaa
aaaaaabbbaaaaaaaaaaaaaaaaa
aaaaaaaaaaaaaaaaaaaaaaaaaa
aaaaaaaaaaaaaaaaaaaaaaaaaa
caaaaaaaaaaaaaaaaaaaaaaaaa
aaaaaaaaaaaaaaaaaaaaaaaaaa
caaaaaaaaaaaaaaaaaaaaaaaaa
aaaaaaaaaaaaaaaaaaaaaaaaaa
aaaaaaaaaaaaaaaaaaaaaaaaaa
"}

(1,1,4) = {"
aaaaaaaaaaaaaaaaaaaaaaaaaa
aaaaaaaaaaaaaaaaaaaaaaaaaa
aaaaaaaaaaaaaaaaaaaaaaaaaa
aaaaaaaaaaaaaaaaaaaaaaaaaa
aaaaaaaaaaaaaaaaaaaaaaaaaa
aaaaaaaaaaaaaaaaaaaaaaaaaa
aaaaaaaaaaaaaaaaaaaaaaaaaa
aaaaaaaaaaaaaaaaaaaaaaaaaa
aaaaaaaaaaaaaaaaaaaaaaaaaa
aaaaaaaaabaaaaaaaaaaaaaaaa
aaaaaaabbaaaaaaaaaaaaaaaaa
aaaaaabaaaaaaaaaaaaaaaaaaa
aaaabbaaabaaaaaaaaaaaaaaaa
aabbaaaaabaaaaaaaaaaaaaaaa
aabbbbbbabaaaaaaaaaaaaaaaa
aaaaaaaabbbbbbaaaaaaaaaaaa
aaaaaaaaabaaabbaaaaaaaaaaa
aaaaaaaaabaaaaaaaaaaaaaaaa
aaaaaaaaabaaaaaaaaaaaaaaaa
caaaaaaaabaaaaaaaaaaaaaaaa
aaaaaaaaabaaaaaaaaaaaaaaaa
caaaaaaaaaaaaaaaaaaaaaaaaa
aaaaaaaaaaaaaaaaaaaaaaaaaa
aaaaaaaaaaaaaaaaaaaaaaaaaa
aaaaaaaaaaaaaaaaaaaaaaaaaa
aaaaaaaaaaaaaaaaaaaaaaaaaa
"}

(1,1,5) = {"
aaaaaaaaaaaaaaaaaaaaaaaaaa
aaaaaaaaaaaaaaaaaaaaaaaaaa
aaaaaaaaaaaaaaaaaaaaaaaaaa
aaaaaaaaaaaaaaaaaaaaaaaaaa
aaaaaaaaaaaaaaaaaaaaaaaaaa
aaaaaaaaaaaaaaaaaaaaaaaaaa
aaaaaaaaaaaaaaaaaaaaaaaaaa
aaaaaaaaaaaaaaaaaaaaaaaaaa
aaaaaabbbbbbaaaaaaaaaaaaaa
aaaaaabaaaaaaaaaaaaaaaaaaa
aaaaaabaaaaaaaaaaaaaaaaaaa
aaaaaabaaaaaaaaaaaaaaaaaaa
aaaaaabaaaaaaaaaaaaaaaaaaa
aaaaaabbbbbbaaaaaaaaaaaaaa
aaaaaaaaaaabbaaaaaaaaaaaaa
aaaaaaaaaaaabaaaaaaaaaaaaa
aaaaaaaaaaaabaaaaaaaaaaaaa
caaaaaaaaaabaaaaaaaaaaaaaa
aaaaaaaaaabbaaaaaaaaaaaaaa
caaabbaabbbaaaaaaaaaaaaaaa
aaaaabbbaaaaaaaaaaaaaaaaaa
aaaaaaaaaaaaaaaaaaaaaaaaaa
aaaaaaaaaaaaaaaaaaaaaaaaaa
aaaaaaaaaaaaaaaaaaaaaaaaaa
aaaaaaaaaaaaaaaaaaaaaaaaaa
aaaaaaaaaaaaaaaaaaaaaaaaaa
"}

(1,1,6) = {"
aaaaaaaaaaaaaaaaaaaaaaaaaa
aaaaaaaaaaaaaaaaaaaaaaaaaa
aaaaaaaaaaaaaaaaaaaaaaaaaa
aaaaaaaaaaaaaaaaaaaaaaaaaa
aaaaaaaaaaaaaaaaaaaaaaaaaa
aaaaaaaaaaaaaaaaaaaaaaaaaa
aaaaaaaaaaaaaaaaaaaaaaaaaa
aaaaaaaaaaaaaaaaaaaaaaaaaa
aaaaaaaaaabaaaaaaaaaaaaaaa
aaaaaaaaabbaaaaaaaaaaaaaaa
aaaaaaaaabaaaaaaaaaaaaaaaa
aaaaaaaabaaaaaaaaaaaaaaaaa
aaaaaaabbaaaaaaaaaaaaaaaaa
aaaaaaabbbaaaaaaaaaaaaaaaa
aaaaaaababbaaaaaaaaaaaaaaa
caaaaaabaabaaaaaaaaaaaaaaa
aaaaaaabaabaaaaaaaaaaaaaaa
caaaaaababbaaaaaaaaaaaaaaa
aaaaaaabbaaaaaaaaaaaaaaaaa
aaaaaaaaaaaaaaaaaaaaaaaaaa
aaaaaaaaaaaaaaaaaaaaaaaaaa
aaaaaaaaaaaaaaaaaaaaaaaaaa
aaaaaaaaaaaaaaaaaaaaaaaaaa
aaaaaaaaaaaaaaaaaaaaaaaaaa
aaaaaaaaaaaaaaaaaaaaaaaaaa
aaaaaaaaaaaaaaaaaaaaaaaaaa
"}

(1,1,7) = {"
aaaaaaaaaaaaaaaaaaaaaaaaaa
aaaaaaaaaaaaaaaaaaaaaaaaaa
aaaaaaaaaaaaaaaaaaaaaaaaaa
aaaaaaaaaaaaaaaaaaaaaaaaaa
aaaaaaaaaaaaaaaaaaaaaaaaaa
aaaaaaaaaaaaaaaaaaaaaaaaaa
aaaaaaaaaaaaaaaaaaaaaaaaaa
aaaaaaaaaaaaaaaaaaaaaaaaaa
aaaaaaaaaaaaaaaaaaaaaaaaaa
aaaaaabaaaaaaaabaaaaaaaaaa
aaaaaabbbbbbbbbbaaaaaaaaaa
aaaaaaaaaaaaaabbaaaaaaaaaa
aaaaaaaaaaaaaabaaaaaaaaaaa
aaaaaaaaaaaaaabaaaaaaaaaaa
aaaaaaaaaaaaabaaaaaaaaaaaa
caaaaaaabbbaabaaaaaaaaaaaa
aaaaaaaaaabbbbaaaaaaaaaaaa
aaaaaaaaaaabaaaaaaaaaaaaaa
aaaaaaaaaabbaaaaaaaaaaaaaa
aaaaaaaaabbaaaaaaaaaaaaaaa
aaaaaaaaabaaaaaaaaaaaaaaaa
aaaaaaaaaaaaaaaaaaaaaaaaaa
aaaaaaaaaaaaaaaaaaaaaaaaaa
aaaaaaaaaaaaaaaaaaaaaaaaaa
aaaaaaaaaaaaaaaaaaaaaaaaaa
aaaaaaaaaaaaaaaaaaaaaaaaaa
"}
