"a" = (/turf/open/outside,/area/space)
"b" = (/turf/closed/wall,/area/space)
"c" = (/turf/open/floor/wood,/area/space)
"d" = (/obj/structure/ladder,/turf/open/floor/wood,/area/space)
"e" = (/turf/open/hole/outside,/area/space)
"f" = (/turf/open/hole,/area/space)
"g" = (/turf/open/floor/plasteel,/area/space)
"h" = (/obj/structure/ladder,/turf/open/outside,/area/space)

(1,1,1) = {"
aaaaaaaaaaaaaaaaaaaaaaaaaa
aaaaaaaaaaaaaaaaaaaaaaaaaa
aaaaaaaaaaaaaaaaaaaaaaaaaa
aaaaaaaaaaaaaaaaaaaaaaaaaa
aaaaaaaaaaaaaaaaaaaaaaaaaa
aaaaaaaaaaaaaaaaaaaaaaaaaa
aaaaaaaaaaaaaaaaaaaaaaaaaa
aabbbbbbbbbbbbbbaaaaaaaaaa
aabccccccccccccbaaaaaaaaaa
aabccccccccccccbaaaaaaaaaa
aabccccccccccccbaaaaaaaaaa
aabccccccccccccbaaaaaaaaaa
aabccccccccccccbaaaaaaaaaa
aabccccccccccccbaaaaaaaaaa
aabccccccccccccbaaaaaaaaaa
aabccccccccccccbaaaaaaaaaa
aabccccccccccccbaaaaaaaaaa
aabccccccccccccbaaaaaaaaaa
aabccccdcccccccbaaaaaaaaaa
aabbccbbbbbbbbbbaaaaaaaaaa
aaaaaaaaaaaaaaaaaaaaaaaaaa
aaaaaaaaaaaaaaaaaaaaaaaaaa
aaaaaaaaaaaaaaaaaaaaaaaaaa
aaaaaaaaaaaaaaaaaaaaaaaaaa
aaaaaaaaaaaaaaaaaaaaaaaaaa
aaaaaaaaaaaaaaaaaaaaaaaaaa
"}

(1,1,2) = {"
eeeeeeeeeeeeeeeeeeeeeeeeee
eeeeeeeeeeeeeeeeeeeeeeeeee
eeeeeeeeeeeeeeeeeeeeeeeeee
eeeeeeeeeeeeeeeeeeeeeeeeee
eeeeeeeeeeeeeeeeeeeeeeeeee
eeeeeeeeeeeeeeeeeeeeeeeeee
eeeeeeeeeeeeeeeeeeeeeeeeee
eebcccccccccccbbeeeeeeeeee
eebccccccccccccceeeeeeeeee
eeccdcccfffccccceeeeeeeeee
eeccccccfffccccceeeeeeeeee
eecccccccccccccceeeeeeeeee
eecccccccccccccceeeeeeeeee
eecccccccccccccceeeeeeeeee
eecccccccccccccceeeeeeeeee
eecccccccccccccceeeeeeeeee
eecccccccccccccceeeeeeeeee
eecccccccccccccceeeeeeeeee
eebccccdcccccccbeeeeeeeeee
eebbccccccccccbbeeeeeeeeee
eeeeeeeeeeeeeeeeeeeeeeeeee
eeeeeeeeeeeeeeeeeeeeeeeeee
eeeeeeeeeeeeeeeeeeeeeeeeee
eeeeeeeeeeeeeeeeeeeeeeeeee
eeeeeeeeeeeeeeeeeeeeeeeeee
eeeeeeeeeeeeeeeeeeeeeeeeee
"}

(1,1,3) = {"
eeeeeeeeeeeeeeeeeeeeeeeeee
eeeeeeeeeeeeeeeeeeeeeeeeee
eeeeeeeeeeeeeeeeeeeeeeeeee
eeeeeeeeeeeeeeeeeeeeeeeeee
eeeeeeeeeeeeeeeeeeeeeeeeee
eeeeeeeeeeeeeeeeeeeeeeeeee
eeeeeeeeeeeeeeeeeeeeeeeeee
eebbccccccccccbbeeeeeeeeee
eebccccfffffcccbeeeeeeeeee
eeccdccfffffcccceeeeeeeeee
eecccccfffffcccceeeeeeeeee
eecccccccccccccceeeeeeeeee
eecccccccccccccceeeeeeeeee
eecccccccccccccceeeeeeeeee
eecccccccccccccceeeeeeeeee
eecccccccccccccceeeeeeeeee
eecccccccccccccceeeeeeeeee
eecccccccccccccceeeeeeeeee
eebccccccccccccbeeeeeeeeee
eebbccccccccccbbeeeeeeeeee
eeeeeeeeeeeeeeeeeeeeeeeeee
eeeeeeeeeeeeeeeeeeeeeeeeee
eeeeeeeeeeeeeeeeeeeeeeeeee
eeeeeeeeeeeeeeeeeeeeeeeeee
eeeeeeeeeeeeeeeeeeeeeeeeee
eeeeeeeeeeeeeeeeeeeeeeeeee
"}

(1,1,4) = {"
eeeeeeeeeeeeeeeeeeeeeeeeee
eeeeeeeeeeeeeeeeeeeeeeeeee
eeeeeeeeeeeeeeeeeeeeeeeeee
eeeeeeeeeeeeeeeeeeeeeeeeee
eeeeeeeeeeeeeeeeeeeeeeeeee
eeeeeeeeeeeeeeeeeeeeeeeeee
eeeeeeeeeeeeeeeeeeeeeeeeee
eebbccccccccccbbeeeeeeeeee
eebcccfffffffccbeeeeeeeeee
eeccdcfffffffccceeeeeeeeee
eeccccfffffffccceeeeeeeeee
eecccccccccccccceeeeeeeeee
eecccccccccccccceeeeeeeeee
eecccccccccccccceeeeeeeeee
eecccccccccccccceeeeeeeeee
eecccccccccccccceeeeeeeeee
eecccccccccccccceeeeeeeeee
eecccccccccccccceeeeeeeeee
eebccccccccccccbeeeeeeeeee
eebbccccccccccbbeeeeeeeeee
eeeeeeeeeeeeeeeeeeeeeeeeee
eeeeeeeeeeeeeeeeeeeeeeeeee
eeeeeeeeeeeeeeeeeeeeeeeeee
eeeeeeeeeeeeeeeeeeeeeeeeee
eeeeeeeeeeeeeeeeeeeeeeeeee
eeeeeeeeeeeeeeeeeeeeeeeeee
"}

(1,1,5) = {"
aaaaaaaaaaaaaaaaaaaaaaaaaa
aaaaaaaaaaaaaaaaaaaaaaaaaa
aaaaaaaaaaaaaaaaaaaaaaaaaa
aaaaaaaaaaaaaaaaaaaaaaaaaa
aaaaaaaaaaaaaaaaaaaaaaaaaa
aaaaaaaaaaaaaaaaaaaaaaaaaa
aaaaaaaaaaaaaaaaaaaaaaaaaa
aaaaaaaaaaaaaaaaaaaaaaaaaa
aaaaaaggggggaaaaaaaaaaaaaa
aaaaaagaaaaaaaaaaaaaaaaaaa
aaaaaagaaaaaaaaaaaaaaaaaaa
aaaaaagaaaaaaaaaaaaaaaaaaa
aaaaaagaaaaaaaaaaaaaaaaaaa
aaaaaaggggggaaaaaaaaaaaaaa
aaaaaaaaaaaggaaaaaaaaaaaaa
aaaaaaaaaaaagaaaaaaaaaaaaa
aaaaaaaaaaaagaaaaaaaaaaaaa
haaaaaaaaaagaaaaaaaaaaaaaa
aaaaaaaaaaggaaaaaaaaaaaaaa
haaaggaagggaaaaaaaaaaaaaaa
aaaaagggaaaaaaaaaaaaaaaaaa
aaaaaaaaaaaaaaaaaaaaaaaaaa
aaaaaaaaaaaaaaaaaaaaaaaaaa
aaaaaaaaaaaaaaaaaaaaaaaaaa
aaaaaaaaaaaaaaaaaaaaaaaaaa
aaaaaaaaaaaaaaaaaaaaaaaaaa
"}

(1,1,6) = {"
aaaaaaaaaaaaaaaaaaaaaaaaaa
aaaaaaaaaaaaaaaaaaaaaaaaaa
aaaaaaaaaaaaaaaaaaaaaaaaaa
aaaaaaaaaaaaaaaaaaaaaaaaaa
aaaaaaaaaaaaaaaaaaaaaaaaaa
aaaaaaaaaaaaaaaaaaaaaaaaaa
aaaaaaaaaaaaaaaaaaaaaaaaaa
aaaaaaaaaaaaaaaaaaaaaaaaaa
aaaaaaaaaagaaaaaaaaaaaaaaa
aaaaaaaaaggaaaaaaaaaaaaaaa
aaaaaaaaagaaaaaaaaaaaaaaaa
aaaaaaaagaaaaaaaaaaaaaaaaa
aaaaaaaggaaaaaaaaaaaaaaaaa
aaaaaaagggaaaaaaaaaaaaaaaa
aaaaaaagaggaaaaaaaaaaaaaaa
haaaaaagaagaaaaaaaaaaaaaaa
aaaaaaagaagaaaaaaaaaaaaaaa
haaaaaagaggaaaaaaaaaaaaaaa
aaaaaaaggaaaaaaaaaaaaaaaaa
aaaaaaaaaaaaaaaaaaaaaaaaaa
aaaaaaaaaaaaaaaaaaaaaaaaaa
aaaaaaaaaaaaaaaaaaaaaaaaaa
aaaaaaaaaaaaaaaaaaaaaaaaaa
aaaaaaaaaaaaaaaaaaaaaaaaaa
aaaaaaaaaaaaaaaaaaaaaaaaaa
aaaaaaaaaaaaaaaaaaaaaaaaaa
"}

(1,1,7) = {"
aaaaaaaaaaaaaaaaaaaaaaaaaa
aaaaaaaaaaaaaaaaaaaaaaaaaa
aaaaaaaaaaaaaaaaaaaaaaaaaa
aaaaaaaaaaaaaaaaaaaaaaaaaa
aaaaaaaaaaaaaaaaaaaaaaaaaa
aaaaaaaaaaaaaaaaaaaaaaaaaa
aaaaaaaaaaaaaaaaaaaaaaaaaa
aaaaaaaaaaaaaaaaaaaaaaaaaa
aaaaaaaaaaaaaaaaaaaaaaaaaa
aaaaaagaaaaaaaagaaaaaaaaaa
aaaaaaggggggggggaaaaaaaaaa
aaaaaaaaaaaaaaggaaaaaaaaaa
aaaaaaaaaaaaaagaaaaaaaaaaa
aaaaaaaaaaaaaagaaaaaaaaaaa
aaaaaaaaaaaaagaaaaaaaaaaaa
haaaaaaagggaagaaaaaaaaaaaa
aaaaaaaaaaggggaaaaaaaaaaaa
aaaaaaaaaaagaaaaaaaaaaaaaa
aaaaaaaaaaggaaaaaaaaaaaaaa
aaaaaaaaaggaaaaaaaaaaaaaaa
aaaaaaaaagaaaaaaaaaaaaaaaa
aaaaaaaaaaaaaaaaaaaaaaaaaa
aaaaaaaaaaaaaaaaaaaaaaaaaa
aaaaaaaaaaaaaaaaaaaaaaaaaa
aaaaaaaaaaaaaaaaaaaaaaaaaa
aaaaaaaaaaaaaaaaaaaaaaaaaa
"}
