"a" = (/turf/open/outside,/area/space)
"b" = (/turf/closed/wall,/area/space)
"c" = (/turf/open/floor/wood,/area/space)
"d" = (/turf/open/stairs/moving/northup,/area/space)
"e" = (/turf/open/stairs/north,/area/space)
"f" = (/obj/structure/ladder,/turf/open/floor/wood,/area/space)
"g" = (/turf/open/hole/outside,/area/space)
"h" = (/turf/open/hole,/area/space)
"i" = (/turf/open/stairs/moving/westup,/area/space)
"j" = (/turf/open/stairs/west,/area/space)
"k" = (/turf/open/stairs/moving/northdown,/area/space)
"l" = (/turf/open/stairs/south,/area/space)
"m" = (/turf/open/stairs/moving/westdown,/area/space)
"n" = (/turf/open/stairs/moving/southup,/area/space)
"o" = (/turf/open/stairs/moving/southdown,/area/space)
"p" = (/turf/open/floor/plasteel,/area/space)
"q" = (/obj/structure/ladder,/turf/open/outside,/area/space)

(1,1,1) = {"
aaaaaaaaaaaaaaaaaaaaaaaaaa
aaaaaaaaaaaaaaaaaaaaaaaaaa
aaaaaaaaaaaaaaaaaaaaaaaaaa
aaaaaaaaaaaaaaaaaaaaaaaaaa
aaaaaaaaaaaaaaaaaaaaaaaaaa
aaaaaaaaaaaaaaaaaaaaaaaaaa
aaaaaaaaaaaaaaaaaaaaaaaaaa
aabbbbbbbbbbbbbbaaaaaaaaaa
aabccccccccccccbaaaaaaaaaa
aabccccccccccccbaaaaaaaaaa
aabccccccccccccbaaaaaaaaaa
aabccccccccccccbaaaaaaaaaa
aabccccccccccccbaaaaaaaaaa
aabccccccccccccbaaaaaaaaaa
aabcccccccbbbbbbaaaaaaaaaa
aabcccccccbdddbbaaaaaaaaaa
aabcccccccbeeebbaaaaaaaaaa
aabcccccccbeeebbaaaaaaaaaa
aabccccfcccccccbaaaaaaaaaa
aabbccbbbbbbbbbbaaaaaaaaaa
aaaaaaaaaaaaaaaaaaaaaaaaaa
aaaaaaaaaaaaaaaaaaaaaaaaaa
aaaaaaaaaaaaaaaaaaaaaaaaaa
aaaaaaaaaaaaaaaaaaaaaaaaaa
aaaaaaaaaaaaaaaaaaaaaaaaaa
aaaaaaaaaaaaaaaaaaaaaaaaaa
"}

(1,1,2) = {"
gggggggggggggggggggggggggg
gggggggggggggggggggggggggg
gggggggggggggggggggggggggg
gggggggggggggggggggggggggg
gggggggggggggggggggggggggg
gggggggggggggggggggggggggg
gggggggggggggggggggggggggg
ggbcccccccccccbbgggggggggg
ggbcccccccccccccgggggggggg
ggccfccchhhcccccgggggggggg
ggcccccchhhcccccgggggggggg
ggccccccccccccccgggggggggg
ggccccccccccccccgggggggggg
ggcccbbbccbeeebcgggggggggg
ggcccbijccbeeebcgggggggggg
ggcccbijccbkkkbcgggggggggg
ggcccbbbccbbbbbcgggggggggg
ggccccccccccccccgggggggggg
ggbccccfcccccccbgggggggggg
ggbbccccccccccbbgggggggggg
gggggggggggggggggggggggggg
gggggggggggggggggggggggggg
gggggggggggggggggggggggggg
gggggggggggggggggggggggggg
gggggggggggggggggggggggggg
gggggggggggggggggggggggggg
"}

(1,1,3) = {"
gggggggggggggggggggggggggg
gggggggggggggggggggggggggg
gggggggggggggggggggggggggg
gggggggggggggggggggggggggg
gggggggggggggggggggggggggg
gggggggggggggggggggggggggg
gggggggggggggggggggggggggg
ggbbccccccccccbbgggggggggg
ggbcccchhhhhcccbgggggggggg
ggccfcchhhhhccccgggggggggg
ggccccchhhhhccccgggggggggg
ggccccccccccccccgggggggggg
ggccccccccccccccgggggggggg
ggcccbbbcblbccccgggggggggg
ggcccjmbcbnbccccgggggggggg
ggcccjmbcbbbccccgggggggggg
ggcccbbbccccccccgggggggggg
ggccccccccccccccgggggggggg
ggbccccccccccccbgggggggggg
ggbbccccccccccbbgggggggggg
gggggggggggggggggggggggggg
gggggggggggggggggggggggggg
gggggggggggggggggggggggggg
gggggggggggggggggggggggggg
gggggggggggggggggggggggggg
gggggggggggggggggggggggggg
"}

(1,1,4) = {"
gggggggggggggggggggggggggg
gggggggggggggggggggggggggg
gggggggggggggggggggggggggg
gggggggggggggggggggggggggg
gggggggggggggggggggggggggg
gggggggggggggggggggggggggg
gggggggggggggggggggggggggg
ggbbccccccccccbbgggggggggg
ggbccchhhhhhhccbgggggggggg
ggccfchhhhhhhcccgggggggggg
ggcccchhhhhhhcccgggggggggg
ggccccccccccccccgggggggggg
ggccccccccccccccgggggggggg
ggcccccccbbbccccgggggggggg
ggcccccccbobccccgggggggggg
ggcccccccblbccccgggggggggg
ggccccccccccccccgggggggggg
ggccccccccccccccgggggggggg
ggbccccccccccccbgggggggggg
ggbbccccccccccbbgggggggggg
gggggggggggggggggggggggggg
gggggggggggggggggggggggggg
gggggggggggggggggggggggggg
gggggggggggggggggggggggggg
gggggggggggggggggggggggggg
gggggggggggggggggggggggggg
"}

(1,1,5) = {"
aaaaaaaaaaaaaaaaaaaaaaaaaa
aaaaaaaaaaaaaaaaaaaaaaaaaa
aaaaaaaaaaaaaaaaaaaaaaaaaa
aaaaaaaaaaaaaaaaaaaaaaaaaa
aaaaaaaaaaaaaaaaaaaaaaaaaa
aaaaaaaaaaaaaaaaaaaaaaaaaa
aaaaaaaaaaaaaaaaaaaaaaaaaa
aaaaaaaaaaaaaaaaaaaaaaaaaa
aaaaaappppppaaaaaaaaaaaaaa
aaaaaapaaaaaaaaaaaaaaaaaaa
aaaaaapaaaaaaaaaaaaaaaaaaa
aaaaaapaaaaaaaaaaaaaaaaaaa
aaaaaapaaaaaaaaaaaaaaaaaaa
aaaaaappppppaaaaaaaaaaaaaa
aaaaaaaaaaappaaaaaaaaaaaaa
aaaaaaaaaaaapaaaaaaaaaaaaa
aaaaaaaaaaaapaaaaaaaaaaaaa
qaaaaaaaaaapaaaaaaaaaaaaaa
aaaaaaaaaappaaaaaaaaaaaaaa
qaaappaapppaaaaaaaaaaaaaaa
aaaaapppaaaaaaaaaaaaaaaaaa
aaaaaaaaaaaaaaaaaaaaaaaaaa
aaaaaaaaaaaaaaaaaaaaaaaaaa
aaaaaaaaaaaaaaaaaaaaaaaaaa
aaaaaaaaaaaaaaaaaaaaaaaaaa
aaaaaaaaaaaaaaaaaaaaaaaaaa
"}

(1,1,6) = {"
aaaaaaaaaaaaaaaaaaaaaaaaaa
aaaaaaaaaaaaaaaaaaaaaaaaaa
aaaaaaaaaaaaaaaaaaaaaaaaaa
aaaaaaaaaaaaaaaaaaaaaaaaaa
aaaaaaaaaaaaaaaaaaaaaaaaaa
aaaaaaaaaaaaaaaaaaaaaaaaaa
aaaaaaaaaaaaaaaaaaaaaaaaaa
aaaaaaaaaaaaaaaaaaaaaaaaaa
aaaaaaaaaapaaaaaaaaaaaaaaa
aaaaaaaaappaaaaaaaaaaaaaaa
aaaaaaaaapaaaaaaaaaaaaaaaa
aaaaaaaapaaaaaaaaaaaaaaaaa
aaaaaaappaaaaaaaaaaaaaaaaa
aaaaaaapppaaaaaaaaaaaaaaaa
aaaaaaapappaaaaaaaaaaaaaaa
qaaaaaapaapaaaaaaaaaaaaaaa
aaaaaaapaapaaaaaaaaaaaaaaa
qaaaaaapappaaaaaaaaaaaaaaa
aaaaaaappaaaaaaaaaaaaaaaaa
aaaaaaaaaaaaaaaaaaaaaaaaaa
aaaaaaaaaaaaaaaaaaaaaaaaaa
aaaaaaaaaaaaaaaaaaaaaaaaaa
aaaaaaaaaaaaaaaaaaaaaaaaaa
aaaaaaaaaaaaaaaaaaaaaaaaaa
aaaaaaaaaaaaaaaaaaaaaaaaaa
aaaaaaaaaaaaaaaaaaaaaaaaaa
"}

(1,1,7) = {"
aaaaaaaaaaaaaaaaaaaaaaaaaa
aaaaaaaaaaaaaaaaaaaaaaaaaa
aaaaaaaaaaaaaaaaaaaaaaaaaa
aaaaaaaaaaaaaaaaaaaaaaaaaa
aaaaaaaaaaaaaaaaaaaaaaaaaa
aaaaaaaaaaaaaaaaaaaaaaaaaa
aaaaaaaaaaaaaaaaaaaaaaaaaa
aaaaaaaaaaaaaaaaaaaaaaaaaa
aaaaaaaaaaaaaaaaaaaaaaaaaa
aaaaaapaaaaaaaapaaaaaaaaaa
aaaaaappppppppppaaaaaaaaaa
aaaaaaaaaaaaaappaaaaaaaaaa
aaaaaaaaaaaaaapaaaaaaaaaaa
aaaaaaaaaaaaaapaaaaaaaaaaa
aaaaaaaaaaaaapaaaaaaaaaaaa
qaaaaaaapppaapaaaaaaaaaaaa
aaaaaaaaaappppaaaaaaaaaaaa
aaaaaaaaaaapaaaaaaaaaaaaaa
aaaaaaaaaappaaaaaaaaaaaaaa
aaaaaaaaappaaaaaaaaaaaaaaa
aaaaaaaaapaaaaaaaaaaaaaaaa
aaaaaaaaaaaaaaaaaaaaaaaaaa
aaaaaaaaaaaaaaaaaaaaaaaaaa
aaaaaaaaaaaaaaaaaaaaaaaaaa
aaaaaaaaaaaaaaaaaaaaaaaaaa
aaaaaaaaaaaaaaaaaaaaaaaaaa
"}
